*********G*******************
*       *                   *
* ************************* *
*              *            *
******** ****************** *
*              *            *
* ****** ****************** *
* *                         *
* ************************* *
* *       *          *      *
* ******* ********* *********
*                           *
****** ******* ****** ***** *
*            *      *     * *
******S**********************